TTTTT                  T
TTTT                   T
TTT                  TTT
TTT                 TTTT
TTTT              TTTTTT
TTTTT            TTTTTTT
TTTTTT           TTTTTTT
TTTTTTT           TTTTTT
TTTTTT            TTTTTT
TTTTTTTT         TTTTTTT
TTTTTTTT         TTTTTTT
TTTTT                  T
TTTT                   T
TTT                  TTT
TTT                 TTTT
TTTT              TTTTTT
TTTTT            TTTTTTT
TTTTTT           TTTTTTT
TTTTTTT           TTTTTT
TTTTTT            TTTTTT
TTTTTTTT         TTTTTTT
TTTTTTTT         TTTTTTT
TTTTT                  T
TTTT                   T
TTT                  TTT
TTT                 TTTT
TTTT              TTTTTT
TTTTT            TTTTTTT
TTTTTT           TTTTTTT
TTTTTTT           TTTTTT
TTTTTT            TTTTTT
TTTTTTTT         TTTTTTT
TTTTTTTT         TTTTTTT
TTTTTTTLLLLLLLLLLLTTTTTT
TTTTTT            TTTTTT
TTTTT             TTTTTT
TTTT              TTTTTT
TTTGGGG         TTTTTTTT
TTT            TTTTTTTTT
TTTT            TTTTTTTT
TTTTTT           TTTTTTT
TTTNTTT           TTTTTT
TTTTTTTT           TTTTT
TTTTTTTTGGGG        TTTT
TTTTTTT              TTT
TTTTTT                TT
TTTTT                  T
TTTT                   T
TTT                  TTT
TTT                 TTTT
TTTT              TTTTTT
TTTTT            TTTTTTT
TTTTTT           TTTTTTT
TTTTTTT           TTTTTT
TTTTTT            TTTTTT
TTT             TTTTTTTT
TTT            TTTTTTTTT
TTTT            TTTTTTTT
TTTTTT           TTTTTTT
TTTNTTT           TTTTTT
TTTTTTTT           TTTTT
TTTTTTTTGGGG        TTTT
TTTTTTT              TTT
TTTTTT                TT
TTTTT                  T
TTTT                   T
TTT                  TTT
TTT                 TTTT
TTTT              TTTTTT
TTTTT            TTTTTTT
TTTTTT           TTTTTTT
TTTTTTT           TTTTTT
TTTTTT            TTTTTT
TTT             TTTTTTTT
TTT            TTTTTTTTT
TTTT            TTTTTTTT
TTTTTT           TTTTTTT
TTTNTTT           TTTTTT
TTTTTTTT           TTTTT
TTTTTTTTGGGG        TTTT
TTTTTTT              TTT
TTTTTT                TT
TTTTT                  T
TTTT                   T
TTT                  TTT
TTT                 TTTT
TTTT              TTTTTT
TTTTT            TTTTTTT
TTTTTT           TTTTTTT
TTTTTTT           TTTTTT
TTTTTT            TTTTTT
TTTTTT            TTTTTT
TTTTT             TTTTTT
TTTT              TTTTTT
TTTGGGG         TTTTTTTT
TTT            TTTTTTTTT
TTTT            TTTTTTTT
TTTTTT           TTTTTTT
TTTNTTT           TTTTTT
TTTTTTTT           TTTTT
TTTTTTTTGGGG        TTTT
TTTTTTT              TTT
TTTTTT                TT
TTTTT                  T
TTTT                   T
TTT                  TTT
TTT                 TTTT
TTTT              TTTTTT
TTTTT            TTTTTTT
TTTTTT           TTTTTTT
TTTTTTT           TTTTTT
TTTTTT            TTTTTT
TTT             TTTTTTTT
TTT            TTTTTTTTT
TTTT            TTTTTTTT
TTTTTT           TTTTTTT
TTTNTTT           TTTTTT
TTTTTTTT           TTTTT
TTTTTTTTGGGG        TTTT
TTTTTTT              TTT
TTTTTT                TT
TTTTT                  T
TTTT                   T
TTT                  TTT
TTT                 TTTT
TTTT              TTTTTT
TTTTT            TTTTTTT
TTTTTT           TTTTTTT
TTTTTTT           TTTTTT
TTTTTT            TTTTTT
TTT             TTTTTTTT
TTT            TTTTTTTTT
TTTT            TTTTTTTT
TTTTTT           TTTTTTT
TTTNTTT           TTTTTT
TTTTTTTT           TTTTT
TTTTTTTTGGGG        TTTT
TTTTTTT              TTT
TTTTTT                TT
TTTTT                  T
TTTT                   T
TTT                  TTT
TTT                 TTTT
TTTT              TTTTTT
TTTTT            TTTTTTT
TTTTTT           TTTTTTT
TTTTTTT           TTTTTT
TTTTTT            TTTTTT
TTTTTT            TTTTTT
TTTTT             TTTTTT
TTTT              TTTTTT
TTTGGGG         TTTTTTTT
TTT            TTTTTTTTT
TTTT            TTTTTTTT
TTTTTT           TTTTTTT
TTTNTTT           TTTTTT
TTTTTTTT           TTTTT
TTTTTTTTGGGG        TTTT
TTTTTTT              TTT
TTTTTT                TT
TTTTT                  T
TTTT                   T
TTT                  TTT
TTT                 TTTT
TTTT              TTTTTT
TTTTT            TTTTTTT
TTTTTT           TTTTTTT
TTTTTTT           TTTTTT
TTTTTT            TTTTTT
TTT    GGGGG    TTTTTTTT
TTT            TTTTTTTTT
TTTT            TTTTTTTT
TTTTTT           TTTTTTT
TTTNTTT           TTTTTT
TTTTTTTT           TTTTT



