TTTTT                  T
TTTT                   T
TTT                  TTT
TTT                 TTTT
TTTT              TTTTTT
TTTTT            TTTTTTT
TTTTTT           TTTTTTT
TTTTTTT           TTTTTT
TTTTTT            TTTTTT
TTTTTTTT             TTT
TTTTTTTT             TTT
TTTTT                  T
TTTT                   T
TTT                  TTT
TTT                 TTTT
TTTT              TTTTTT
TTTTT            TTTTTTT
TTTTTT           TTTTTTT
TTTTTTT           TTTTTT
TTTTTT            TTTTTT
TTTTTTTT             TTT
TTTTTTTT             TTT
TTTTT                  T
TTTT                   T
TTT                  TTT
TTT                 TTTT
TTTT              TTTTTT
TTTTT            TTTTTTT
TTTTTT           TTTTTTT
TTTTTTT           TTTTTT
TTTTTT            TTTTTT
TTTTTTTT             TTT
TTTTTTTT             TTT
TTTTTTLLLLLLLLLLLLLLLTTT
TTTTT                TTT
TTTT                 TTT
TTTT                 TTT
TTT                  TTT
TTT                  TTT
TTT    GGGG          TTT
TTTT                 TTT
TTTTT                TTT
TTTTTT               TTT
TTTTTT               TTT
TTTTT                TTT
TTT                  TTT
TTT                  TTT
TTT                  TTT
TTT                  TTT
TTT                  TTT
TTTTTT               TTT
TTTTTTTT             TTT
TTTTTTTT             TTT
TTTTTT               TTT
TTTTT                TTT
TTTT                 TTT
TTTT                 TTT
TTT                  TTT
TTT                  TTT
TTTTT                TTT
TTTT                 TTT
TTTT                 TTT
TTT                  TTT
TTT                  TTT
TTT    GGGG          TTT
TTTT                 TTT
TTTTT                TTT
TTTTTT               TTT
TTTTTT               TTT
TTTTT                TTT
TTT                  TTT
TTT                  TTT
TTT                  TTT
TTT                  TTT
TTT                  TTT
TTTTTT               TTT
TTTTTTTT             TTT
TTTTTTTT             TTT
TTTTTT               TTT
TTTTT                TTT
TTTT                 TTT
TTTT                 TTT
TTT                  TTT
TTT                  TTT


