TTTTT                  T
TTTT                   T
TTT                  TTT
TTT                 TTTT
TTTT              TTTTTT
TTTTT            TTTTTTT
TTTTTT           TTTTTTT
TTTTTTT           TTTTTT
TTTTTT            TTTTTT
TTTTTTTTT          TTTTT
TTTTTTTTT          TTTTT
TTTTT                  T
TTTT                   T
TTT                  TTT
TTT                 TTTT
TTTT              TTTTTT
TTTTT            TTTTTTT
TTTTTT           TTTTTTT
TTTTTTT           TTTTTT
TTTTTT            TTTTTT
TTTTTTTTT          TTTTT
TTTTTTTTT          TTTTT
TTTTT                  T
TTTT                   T
TTT                  TTT
TTT                 TTTT
TTTT              TTTTTT
TTTTT            TTTTTTT
TTTTTT           TTTTTTT
TTTTTTT           TTTTTT
TTTTTT            TTTTTT
TTTTTTTTT          TTTTT
TTTTTTTTT          TTTTT
TTTTTTTLLLLLLLLLLLTTTTTT
TTTTTT            TTTTTT
TTTTTTT GGGG  N TTTTTTTT
TTTTTTTT        TTTTTTTT
TTTTTTTT         TTTTTTT
TTTTTTTTT        TTTTTTT
TTTTTTTTT         TTTTTT
TTTTTTTTTT        TTTTTT
TTTTTTTTT      X   TTTTT
TTTTTTTTT          TTTTT
TTTTTTTTT         TTTTTT
TTTTTTTTT      N TTTTTTT
TTTTTTT  X       TTTTTTT
TTTTT           TTTTTTTT
TTTT           TTTTTTTTT
TTT           TTTTTTTTTT
TTT N        TTTTTTTTTTT
TTT           TTTTTTTTTT
TTTTT          TTTTTTTTT
TTTT  GGGG     TTTTTTTTT
TTTTT          TTTTTTTTT
TTTTT       N   TTTTTTTT
TTTTTTT          TTTTTTT
TTTTTTTT        TTTTTTTT
TTTTTTTTPPPPPPPPPTTTTTTT
TTTTTTT            TTTTT
TTTTTT           X TTTTT
TTTTT              TTTTT
TTTTT             TTTTTT
TTTTT           TTTTTTTT
TTTTTT            TTTTTT
TTTTTTT GGGG  N TTTTTTTT
TTTTTTTT        TTTTTTTT
TTTTTTTT         TTTTTTT
TTTTTTTTT         TTTTTT
TTTTTTTTT         TTTTTT
TTTTTTTTTT        TTTTTT
TTTTTTTTT      X   TTTTT
TTTTTTTTT          TTTTT
TTTTTTTTT         TTTTTT
TTTTTTTTT      N TTTTTTT
TTTTTTT          TTTTTTT
TTTTT           TTTTTTTT
TTTT           TTTTTTTTT
TTT           TTTTTTTTTT
TTT N        TTTTTTTTTTT
TTT         X TTTTTTTTTT
TTTTT          TTTTTTTTT
TTTT  GGGG     TTTTTTTTT
TTTTT          TTTTTTTTT
TTTTT       N   TTTTTTTT
TTTTTTT          TTTTTTT
TTTTTTTT        TTTTTTTT
TTTTTTTT         TTTTTTT
TTTTTTT            TTTTT
TTTTTT           X TTTTT
TTTTT        N     TTTTT
TTTTT             TTTTTT
TTTTT           TTTTTTTT
TTTTTT            TTTTTT
TTTTTTT GGGG  N TTTTTTTT
TTTTTTTT        TTTTTTTT
TTTTTTTT         TTTTTTT
TTTTTTTTT         TTTTTT
TTTTTTTTT         TTTTTT
TTTTTTTTTT        TTTTTT
TTTTTTTTT      X   TTTTT
TTTTTTTTT          TTTTT
TTTTTTTTT         TTTTTT
TTTTTTTTT      N TTTTTTT
TTTTTTT          TTTTTTT
TTTTT           TTTTTTTT
TTTTPPPPPPPPPPPTTTTTTTTT
TTT           TTTTTTTTTT
TTT          TTTTTTTTTTT
TTT           TTTTTTTTTT
TTTTT          TTTTTTTTT
TTTT  GGGG     TTTTTTTTT
TTTTT          TTTTTTTTT
TTTTT       N   TTTTTTTT
TTTTTTT          TTTTTTT
TTTTTTTT        TTTTTTTT
TTTTTTTT         TTTTTTT
TTTTTTT            TTTTT
TTTTTT           X TTTTT
TTTTT        N     TTTTT
TTTTT             TTTTTT
TTTTT           TTTTTTTT
TTTTTT            TTTTTT
TTTTTTT GGGG  N TTTTTTTT
TTTTTTTT        TTTTTTTT
TTTTTTTT         TTTTTTT
TTTTTTTTT         TTTTTT
TTTTTTTTT         TTTTTT
TTTTTTTTTT        TTTTTT
TTTTTTTTT      X   TTTTT
TTTTTTTTT          TTTTT
TTTTTTTTT         TTTTTT
TTTTTTTTT      N TTTTTTT
TTTTTTT          TTTTTTT
TTTTT           TTTTTTTT
TTTT           TTTTTTTTT
TTT           TTTTTTTTTT
TTT          TTTTTTTTTTT
TTT         X TTTTTTTTTT
TTTTT          TTTTTTTTT
TTTT GGGG      TTTTTTTTT
TTTTT          TTTTTTTTT
TTTTT       N   TTTTTTTT
TTTTTTT          TTTTTTT
TTTTTTTT        TTTTTTTT
TTTTTTTT         TTTTTTT
TTTTTTT            TTTTT
TTTTTT           X TTTTT
TTTTT        N     TTTTT
TTTTT             TTTTTT
TTTTT           TTTTTTTT
TTTTTT            TTTTTT
TTTTTTT GGGG  N TTTTTTTT
TTTTTTTT        TTTTTTTT
TTTTTTTT         TTTTTTT
TTTTTTTTT         TTTTTT
TTTTTTTTT         TTTTTT
TTTTTTTTTT        TTTTTT
TTTTTTTTT      X   TTTTT
TTTTTTTTT          TTTTT
TTTTTTTTT         TTTTTT
TTTTTTTTT      N TTTTTTT
TTTTTTT          TTTTTTT
TTTTT           TTTTTTTT
TTTT           TTTTTTTTT
TTT           TTTTTTTTTT
TTT N        TTTTTTTTTTT
TTT           TTTTTTTTTT
TTTTT          TTTTTTTTT
TTTT  GGGG     TTTTTTTTT
TTTTT          TTTTTTTTT
TTTTT       N   TTTTTTTT
TTTTTTT          TTTTTTT
TTTTTTTT        TTTTTTTT
TTTTTTTT         TTTTTTT
TTTTTTT            TTTTT
TTTTTT           X TTTTT
TTTTT        N     TTTTT
TTTTT             TTTTTT
TTTTT  GGGG     TTTTTTTT
TTTTTT            TTTTTT
TTTTTTT       N TTTTTTTT
TTTTTTTT X      TTTTTTTT
TTTTTTTT         TTTTTTT
TTTTTTTTT         TTTTTT
TTTTTTTTT         TTTTTT
TTTTTTTTTT        TTTTTT
TTTTTTTTTN         TTTTT
TTTTTTTTT          TTTTT
TTTTTTTTT         TTTTTT
TTTTTTTTT      N TTTTTTT
TTTTTTT  X       TTTTTTT
TTTTT           TTTTTTTT
TTTT           TTTTTTTTT
TTT           TTTTTTTTTT
TTT N        TTTTTTTTTTT
TTT           TTTTTTTTTT
TTTTT          TTTTTTTTT
TTTT GGGG      TTTTTTTTT
TTTTT          TTTTTTTTT
TTTTT           TTTTTTTT
TTTTTTT          TTTTTTT
TTTTTTTT        TTTTTTTT
TTTTTTTTPPPPPPPPPTTTTTTT
TTTTTTT            TTTTT
TTTTTT N         X TTTTT
TTTTT              TTTTT
TTTTT             TTTTTT
TTTTT           TTTTTTTT
TTTTTT            TTTTTT
TTTTTTT GGGG  N TTTTTTTT
TTTTTTTT        TTTTTTTT
TTTTTTTT         TTTTTTT
TTTTTTTTT         TTTTTT
TTTTTTTTT         TTTTTT
TTTTTTTTTT        TTTTTT
TTTTTTTTTN     X   TTTTT
TTTTTTTTT          TTTTT
TTTTTTTTT         TTTTTT
TTTTTTTTT      N TTTTTTT
TTTTTTT          TTTTTTT
TTTTT           TTTTTTTT
TTTT   GGGG    TTTTTTTTT
TTT           TTTTTTTTTT
TTT          TTTTTTTTTTT
TTT           TTTTTTTTTT
TTTTT          TTTTTTTTT
TTTT           TTTTTTTTT
TTTTT          TTTTTTTTT
TTTTT           TTTTTTTT
TTTTTTT          TTTTTTT
TTTTTTTT        TTTTTTTT
