TTTTTTTTT       TTTTTTTT
TTTTTTTT   x      TTTTTT
TTTTTTT            TTTTT
TTTTTT             TTTTT
TTTTTT         x   TTTTT
TTTTTTT            TTTTT
TTTTTTTT         TTTTTTT
TTTTTTTTT       TTTTTTTT
TTTTTTTTT   T    TTTTTTT
TTTTTTT     TTT   TTTTTT
TTTTTT   X TTTTTT  TTTTT
TTTTTT    TTTTTTT   TTTT
TTTTT       TTTT     TTT
TTTTT             X TTTT
TTTTT               TTTT
TTTTT     X         TTTT
TTTTTT              TTTT
TTTTTTT            TTTTT
TTTTTTTTT         TTTTTT
TTTTTTTTTT      TTTTTTTT